1111111111111111111111111111111111111111111111111111111111111111111111111111111111111111111111111111
1111111111111111111111111111111111111111111111111111111111111111111111111111111111111111111111111111
1111111111111111111111111111111111111111111111111111111111111111111111111111111111111111111111111111
1111111111111111111111111111111111111111111111111111111111111111111111111111111111111111111111111111
1111111111111111111111111111111111111111111111111111111111111111111111111111111111111111111111111111
1111111111111111111111111111111111111111111111111111111111111111111111111111111111111111111111111111
1111111111111111111111111111111111111111111111111111111111111111111111111111111111111111111111111111
1111111111111111111111111111111111111111111111111111111111111111111111111111111111111111111111111111
1111111111111111111111111111111111111111111111111111111111111111111111111111111111111111111111111111
1111111111111111111111111111111111111111111111111111111111111111111111111111111111111111111111111111
1111111111000000000000000000000000000000000000000000000000000000000000000000000000000000000011111111
1111111111000000000000000000000000000000000000000000000000000000000000000000000000000000000011111111
1111111111000000000000000000000000000000000000000000000000000000000000000000000000000000000011111111
1111111111000000000000000000000000000000000000000000000000000000000000000000000000000000000011111111
1111111111000000000000000000000000000000000000000000000000000000000111111111111111111111000011111111
1111111111000000000000000000000000000000000000000000000000000000000111111111111111111111000011111111
1111111111000000111111111111111111111111111111111111111111111100000111111111111111111111000011111111
1111111111000000111111111111111111111111111111111111111111111100000111111111111111111111000011111111
1111111111000000111111111111111111111111111111111111111111111100000111111111111111111111000011111111
1111111111000000111111111111111111111111111111111111111111111100000111111111111111111111000011111111
1111111111000000111111111111111111111111111111111111111111111100000111111111111111111111000011111111
1111111111000000111111111111111111111111111111111111111111111100000111111111111111111111000000000000
1111111111000000111111111111111111111111111111111111111111111100000111111111111111111111000000000000
1111111111000000111111111111111111111111111111111111111111111100000111111111111111111111000000000000
1111111111000000000000000000000000000000000000000000000000000000000000000000000000000000000000000000
1111111111000000000000000000000000000000000000000000000000000000000000000000000000000000000000000000
1111111111000000000000000000000000000000000000000000000000000000000000000000000000000000000000000000
1111111111000000000000000000000000000000000000000000000000000000000000000000000000000000000000000000
1111111111000000000000000000000000000000000000000000000000000000000000000000000000000000000000000000
1111111111000000111111111111111111111111111111111111111111111100000000000000000000000000000000000000
1111111111000000111111111111111111111111111111111111111111111100000000000000000000000000000000000000
1111111111000000111111111111111111111111111111111111111111111100000000000000000000000000000000000000
1111111111000000111111111111111111111111111111111111111111111100000000000000000000000000000000000000
1111111111000000111111111111111111111111111111111111111111111100000111111111111111111000000011111111
1111111111000000111111111111111111111111111111111111111111111100000111111111111111111000000011111111
1111111111000000111111111111111111111111111111111111111111111100000111111111111111111000000011111111
1111111111000000111111111111111111111111111111111111111111111100000111111111111111111000000011111111
1111111111000000111111111111111111111111111111111111111111111100000111111111111111111000000011111111
1111111111000000111111111111111111111111111111111111111111111100000111111111111111111000000011111111
1111111111000000111111111111111111111111111111111111111111111100000111111111111111111000000011111111
1111111111000000111111111111111111111111111111111111111111111100000111111111111111111000000011111111
1111111111000000111111111111111111111111111111111111111111111100000111111111111111111000000011111111
1111111111000000111111111111111111111111111111111111111111111100000111111111111111111000000011111111
1111111111000000111111111111111111111111111111111111111111111100000111111111111111111000000011111111
1111111111000000111111111111111111111111111111111111111111111100000111111111111111111000000011111111
1111111111000000111111111111111111111111111111111111111111111100000111111111111111111000000011111111
1111111111000000111111111111111111111111111111111111111111111100000111111111111111111000000011111111
1111111111000000111111111111111111111111111111111111111111111100000111111111111111111000000011111111
1111111111000000111111111111111111111111111111111111111111111100000111111111111111111000000011111111
1111111111000000000000000000000000000000000000000000000000000000000111111111111111111000000011111111
1111111111000000000000000000000000000000000000000000000000000000000111111111111111111000000011111111
1111111111000000000000000000000000000000000000000000000000000000000111111111111111111000000011111111
1111111111000000000000000000000000000000000000000000000000000000000111111111111111111000000011111111
1111111111000000000000000000000000000000000000000000000000000000000111111111111111111000000011111111
1111111111000000111111111111111111111111111111111111111111111100000111111111111111111000000011111111
1111111111000000111111111111111111111111111111111111111111111100000111111111111111111000000011111111
1111111111000000111111111111111111111111111111111111111111111100000000000000000000000000000011111111
1111111111000000111111111111111111111111111111111111111111111100000000000000000000000000000011111111
1111111111000000111111111111111111111111111111111111111111111100000000000000000000000000000011111111
1111111111000000111111111111111111111111111111111111111111111100000000000000000000000000000011111111
1111111111000000111111111111111111111111111111111111111111111100000000000000000000000000000011111111
1111111111000000111111111111111111111111111111111111111111111100000111111111111111111000000011111111
1111111111000000111111111111111111111111111111111111111111111100000111111111111111111000000011111111
1111111111000000111111111111111111111111111111111111111111111100000111111111111111111000000011111111
1111111111000000111111111111111111111111111111111111111111111100000111111111111111111000000011111111
1111111111000000111111111111111111111111111111111111111111111100000111111111111111111000000011111111
1111111111000000000000000000000000000000000000000000000000000000000111111111111111111000000011111111
1111111111000000000000000000000000000000000000000000000000000000000111111111111111111000000011111111
1111111111000000000000000000000000000000000000000000000000000000000111111111111111111000000011111111
1111111111000000000000000000000000000000000000000000000000000000000000000000000000000000000000000000
1111111111000000000000000000000000000000000000000000000000000000000000000000000000000000000000000000
1111111111000000111111111111111111111111111111111111111111111100000000000000000000000000000000000000
1111111111000000111111111111111111111111111111111111111111111100000000000000000000000000000000000000
1111111111000000111111111111111111111111111111111111111111111100000000000000000000000000000000000000
1111111111000000111111111111111111111111111111111111111111111100000111111111111111111111111111111111
1111111111000000111111111111111111111111111111111111111111111100000111111111111111111111111111111111
1111111111000000000000000000000000000000000000000000000000000000000111111111111111111111111111111111
1111111111000000000000000000000000000000000000000000000000000000000111111111111111111111111111111111
1111111111000000000000000000000000000000000000000000000000000000000111111111111111111111111111111111
1111111111000000000000000000000000000000000000000000000000000000000111111111111111111111111111111111
1111111111111111111111111111111111111111111111111111111111111111111111111111111111111111111111111111
1111111111111111111111111111111111111111111111111111111111111111111111111111111111111111111111111111
1111111111111111111111111111111111111111111111111111111111111111111111111111111111111111111111111111
1111111111111111111111111111111111111111111111111111111111111111111111111111111111111111111111111111
1111111111111111111111111111111111111111111111111111111111111111111111111111111111111111111111111111
1111111111111111111111111111111111111111111111111111111111111111111111111111111111111111111111111111
1111111111111111111111111111111111111111111111111111111111111111111111111111111111111111111111111111
1111111111111111111111111111111111111111111111111111111111111111111111111111111111111111111111111111
1111111111111111111111111111111111111111111111111111111111111111111111111111111111111111111111111111
1111111111111111111111111111111111111111111111111111111111111111111111111111111111111111111111111111